SSSSSSSSSSSSSSSSSSSSSSSSSSSSSSSSSSSSSSSS
SMBMMBMMWMBMMM MWMMM MBMW MMMMMMWMMBBMMS
SMMMMMMMWMMMMMM W  M MMMW MM MMMWMMMM MS
S              B BB      B           B S
S MMMMMMWMBMMMMBWMBM MM WMMBMM MWMMBMBMS
SMMMMMMMWMBMMMMBWMBM  MMWMMMMMBMWMMM MMS
SWWWWWWWWWWWWWWWWWWB WWWWWWWWWWWWWWWWWWS
SMMMMBBMWMM MMMMWMMM MMBWMMMM MMWMMMMM S
SMMMMMMMWMM MMMMWMMB MMMWMMMMBM WMMMMMBS
S          B                 B        BS
SBMMBMMMWMMMMBMMWMMB MMMWMMMMMM W MMMMMS
SBMMMMBMWMMBMMBMWMMM M  WMMMMMMMWBMMMBMS
SMBMMMMMWMMMBMMMWMMM MBBWMMMMMMMWBBMMBME
SWWWWWWWWWWWWWWWWWWW WWWWWWWWWWWWWWWWWWS
SBM F MMWMMMMBMBWMMM MMMWMB MMBMWMMMMMMS
SMMMMM MW MMMMMMWMM  MMMW MM MMMWM M  MS
S        B                  B     B BB S
S MM MBMWBMMMMBMWMBM MMBWMBMBMMMWMMMMMMS
SMMMMMBMWBMM MMMWMMM  MMWMMBMMMMWMMM   S
SM MMMB WMM MMMMWMRDBEMMWM MMMMMWMMMBBBS
SMBMMMMBWMMBMMBMWMSMBMMMWMMMMBMBWMMMMBMS
SSSESSSSSSSSSSSSSESSSSSSSSSESSSSSSSSSSSS
